###################################################################################################################################################
#........................................#..............................................#.........................................................#
#........................................#...............................................#........................................................#
#........................................#................................................#.......................................................#
#........................................#.................................................#......................................................#
#........................................#..................................................#.....................................................#
#........................................#...................................................#....................................................#
#........................................#....................................................#...................................................#
#........................................#.....................................................#..................................................#
#........................................#......................................................#.................................................#
#........................................#.......................................................#................####################............#
#........................................#........................................................#...............#..................#............#
#........................................#.........................................................#..............#..................#............#
#........................############################################...............................#.............#..................#............#
#...................................................................#................................#............#..................#............#
#...................................................................#.................................#...........#..................#............#
#...................................................................#..................................#..........#..................#............#
#...................................................................#...................................#.........#########..#########............#
#...................................................................#...............######################........................................#
#...................................................................#...................................#.........................................#
#...................................................................#..................................#..........................................#
#...................................................................#.................................#...........................................#
#...................................................................#................................#............................................#
#...................................................................#...............................#.............................................#
##.........#...#######...#######....................................#..............................#..............................................#
#.#.......##......#......#......#...................................#.............................#...............................................#
#..#.....#.#......#......#......#................................................................#.........................#..#...................#
#...#...#..#......#......#......#...............................................................#.........................#....#..................#
#....#.#...#......#......#######...............................................................#.........................#......#.................#
#.....#....#......#......##.............................................................................................#........#................#
#..........#......#......#.#...........................................................................................#..........#...............#
#..........#......#......#..#.........................................................................................#............#..............#
#..........#......#......#...#.......................................................................................#..............#.............#
#..........#......#......#....#.....................................................................................#................#............#
#..........#...#######...#.....#...................................................................................#..................#...........#
#.................................................................................................................#....................#..........#
#................................................................................................................#......................#.........#
###################################################################################################################################################