#####################################################################################################################################################
#...................................................................................................................................................#
#...................................................................................................................................................#
#...................................................................................................................................................#
#...................................................................................................................................................#
#...................................................................................................................................................#
#........##########################################.................................................................................................#
#......................................................................##########################################...................................#
#....................##########################################.....................................................................................#
#...................................................................................................................................................#
#............................................................................................##########################################.............#
#........................##########################################.................................................................................#
#...................................................................................................................................................#
#....................................................##########################################.....................................................#
#..##########################################.......................................................................................................#
#...................................................................................................................................................#
#...............................................................................................##########################################..........#
#...................................................................................................................................................#
#..........................................................##########################################...............................................#
#...........##########################################..............................................................................................#
#..........................................................................................##########################################...............#
#...................................................................................................................................................#
#.....................................##########################################....................................................................#
#...................................................................................................................................................#
#......##########################################...................................................................................................#
#......................................................................##########################################...................................#
#...................................................................................................................................................#
#.............##########################################............................................................................................#
#......................................................................##########################################...................................#
#...................................................................................................................................................#
#.................##########################################........................................................................................#
#....................................................................##########################################.....................................#
#...................................................................................................................................................#
#................................................................................................##########################################.........#
#............................##########################################.............................................................................#
#...................................................................................................................................................#
#...................................................................................................................................................#
#...................................................................................................................................................#
#####################################################################################################################################################