#####################################################################################################################################################
#........................................#..............................................#...........................................................#
#........................................#...............................................#..........................................................#
#........................................#................................................#.........................................................#
#........................................#.................................................#........................................................#
#........................................#..................................................#.......................................................#
#........................................#...................................................#......................................................#
#........................................#....................................................#.....................................................#
#........................................#.....................................................#....................................................#
#........................................#......................................................#...................................................#
#........................................#.......................................................#................####################..............#
#........................................#........................................................#...............#..................#..............#
#........................................#.........................................................#..............#..................#..............#
#........................############################################...............................#.............#..................#..............#
#...................................................................#................................#............#..................#..............#
#...................................................................#.................................#...........#..................#..............#
#...................................................................#..................................#..........#..................#..............#
#...................................................................#...................................#.........#########..#########..............#
#...................................................................#...............######################..........................................#
#...................................................................#...................................#...........................................#
#...................................................................#..................................#............................................#
#...................................................................#.................................#.............................................#
#...................................................................#................................#..............................................#
#...................................................................#...............................#...............................................#
##.........#...#######...#######....................................#..............................#................................................#
#.#.......##......#......#......#...................................#.............................#.................................................#
#..#.....#.#......#......#......#................................................................#.........................#..#.....................#
#...#...#..#......#......#......#...............................................................#.........................#....#....................#
#....#.#...#......#......#######...............................................................#.........................#......#...................#
#.....#....#......#......##.............................................................................................#........#..................#
#..........#......#......#.#...........................................................................................#..........#.................#
#..........#......#......#..#.........................................................................................#............#................#
#..........#......#......#...#.......................................................................................#..............#...............#
#..........#......#......#....#.....................................................................................#................#..............#
#..........#...#######...#.....#...................................................................................#..................#.............#
#.................................................................................................................#....................#............#
#................................................................................................................#......................#...........#
#...............................................................................................................#........................#..........#
#####################################################################################################################################################