#####################################################################################################################################################
#...................................................................................................................................................#
#...................................................................................................................................................#
#..................................................................................................................#########........................#
#..........................................................................................##..............................#........................#
#.........................................................................................#.#.............................#.........................#
#........................................................................................#..#............................#..........................#
#.......................................................................................#...#...........................#...........................#
#......................................................................................#....#..........................#............................#
#.....................................................................................#.....#.........................#.............................#
#..........########....#########.......#...............................##............#......#.........................#.............................#
#.........#............#........#......#..............................#.#...................#..........................#............................#
#........#.............#........#.....#.#............................#..#...................#...........................#...........................#
#.......#..............#........#.....#.#...........................#...#...................#............................#..........................#
#......#...............#........#....#...#.........................#....#...................#.............................#.........................#
#.....#................#........#....#...#......##########........#.....#...................#....................##########.........................#
#.....#................#########....#.....#......................##############.............#.......................................................#
#.....#................#............#.....#.............................#...................#.......................................................#
#......#...............#...........#########....##########..............#...........................................................................#
#.......#........###...#...........#.......#............................#...........................................................................#
#........#..........#..#..........#.........#...........................#...........................................................................#
#.........#.........#..#..........#.........#...........................#........................############.......................................#
#..........#........#..#.........#...........#..........................#..................................##....................##########.........#
#...........#########..#.........#...........#..........................#.................................#.....................#..........#........#
#........................................................................................................#......................#..........#........#
#.......................................................................................................#.......................#..........#........#
#......................................................................................................#........................#..........#........#
#.....................................................................................................#.........................#..........#........#
#....................................................................................................#..........................#..........#........#
#...................................................................................................#...........................#..........#........#
#..................................................................................................#............................#..........#........#
#..................................................................................................#............................#..........#........#
#...............................................................................................####............................#..........#........#
#...............................................................................................#...............................#..........#........#
#...............................................................................................############....................#..........#........#
#...............................................................................................................................#..........#........#
#...............................................................................................................................#..........#........#
#................................................................................................................................##########.........#
#####################################################################################################################################################